. . . # # # # # # # # # # # # # # # # # # # # # # # # # # # #
. . . . . . # . . . . . . . . . . . # . . # . . . . . . . . #
# . . # # # # . . # . . # # # # # # # . . # # # # . . # # # #
# . . . . . # . . # . . . . . . . . # . . # . . . . . . . . #
# . . # . . # . . # . . # . . # # # # . . # . . # . . # . . #
# . . # . . . . . # . . # . . . . . . . . . . . # . . # . . #
# # # # # # # . . # # # # # # # # # # # # # . . # . . # . . #
# . . . . . # . . # . . . . . . . . # . . # . . # . . # . . #
# . . # # # # . . # . . # . . # . . # . . # . . # # # # # # #
# . . . . . # . . . . . # . . # . . . . . # . . . . . . . . #
# # # # . . # # # # # # # . . # . . # . . # # # # . . # . . #
# . . # . . # . . . . . . . . # . . # . . # . . # . . # . . #
# . . # . . # . . # . . # . . # . . # # # # . . # # # # # # #
# . . # . . # . . # . . # . . # . . # . . # . . . . . # . . #
# . . # . . # . . # # # # # # # . . # . . # # # # . . # . . #
# . . . . . . . . . . . # . . # . . . . . # . . . . . . . . #
# . . # # # # . . # # # # . . # . . # # # # # # # . . # # # #
# . . . . . # . . . . . # . . . . . . . . . . . . . . . . . #
# # # # . . # # # # # # # . . # . . # # # # . . # # # # # # #
# . . . . . # . . . . . . . . # . . # . . . . . . . . . . . .
# # # # # # # # # # # # # # # # # # # # # # # # # # # # . O .