# # # # # # # # # # # # # # # # # . . . . . . . .
# . . . # . . . . . . # . # . . # . . . . . . . .
# # # # # . # # # . . . . # . # # . . . . . . . .
# . . . . . . . . . # . . . . . # . . . . . . . .
# . # . # . # . # . # . # . # . # . . . . . . . .
# . # O . . # . # # # . # . # . # . . . . . . . .
# . # # # . # . # . . # # . # . . . . . . . . . .
# . # . . . # . # # . # . # . . . . . . . . . . .
# . . . # # # # . # . . . . . # . . . . . . . . .
# . . . . . . . # # . # # . . . . . . . . . . . .
# # # # . # . . . # . # . . # . . . . # . # . . .
# . . . . # . # . . . # # . # . . # # # . # # # .
# . # # . # . # . # . . . . . . . # . # # # . . .
. . . . . . . . . . . . . . . . . # . . # . . . .
# # # # # # # # # # # # # # # # . # . . # . . . .
. . . . . . . . . . . . . . . . . # . . . . . . .
. . . . . # . # # . . # . . # # # # # # . . . . .
. . # # # # # . # # # # # # # . . . . # . . . . .
. . # . . # . . . . . . . . . . . . . # . . . . .
. . # . . # # # # # # # # # # # # # . # . . . . .
. . # # # . . # . . . . . . # . # . # # . . . . .
. . # . # . . . # # # # # # . # . # . # . . . . .
